000000000000000000000000000000
003111111111111111111111111300
001010100001000000100001010100
011010101111111111111101010110
010010101000001000000101010010
011010101011111111110101010110
001010101010100000010101010100
011010101010111111010101010110
010010101010000001010101010010
011010101011111111110101010110
001010101000001000000101010100
011010101111111111111101010110
010010100001000000100001010010
011010111111111111111111010110
001010000001102011000000010100
011111111111001001111111111110
010010000001011101000000010010
011010111111000001111111010110
001010100000111110000001010100
011010111111100011111111010110
010010100000011100000000010010
011011111111111111111111110110
001010100000000000000001010100
011010111111111111111111010110
010010100000000000000001010010
011010111111111111111111010110
001010000000000000000000010100
001011100000000000000001110100
003110111111111111111111011300
000000000000000000000000000000
